{
	"numTilesX": 13,
	"numTilesY": 10,
	"size": [64, 64],
	"offset": [32, -10],
	"tileNames":["", "tile01", "tile02"],
	"tiles":[
				0, 0, 0, 0, 0, 0, 0, 0, 0, 0, 0, 0, 0,
				0, 0, 0, 0, 0, 0, 0, 0, 0, 0, 0, 0, 0,
				0, 0, 0, 0, 0, 0, 0, 0, 0, 0, 0, 0, 0,
				2, 2, 0, 0, 0, 0, 0, 0, 0, 0, 0, 0, 0,
				0, 0, 0, 0, 2, 0, 2, 2, 0, 0, 0, 0, 0,
				0, 0, 0, 0, 0, 0, 0, 0, 0, 0, 0, 0, 0,
				2, 2, 2, 0, 0, 0, 0, 0, 0, 2, 2, 0, 0,
				0, 0, 0, 2, 0, 0, 0, 0, 0, 0, 0, 0, 0,
				0, 0, 0, 0, 0, 0, 0, 2, 0, 0, 0, 0, 0,
				1, 1, 1, 1, 1, 1, 1, 1, 1, 1, 1, 1, 1
			]
}